20
16
11111111111111111111
10000000000000000001
10222002222020000201
10200202002022002201
10222002002020220201
10200202002020000201
10222202222020000201
10000000000000000001
10222002222022200021
10200202000020020021
10222002220022200021
10200202000020200001
10222202222020020021
10000000000000000001
1s000000000000000001
11111111111111111111