16
9
1111111111111111
1021022002022221
1201202202022201
1211111121111111
1000000000000001
1000000000000021
1000000011100111
100s000010200001
111111111111111111