21
18
111111111111111111111
1s0000000000000000001
100000000000000000001
102222202000202222201
100020002000202000001
100020002222202222001
100020002000202000001
100020002000202222201
100000000000000000001
100000000000000000001
102222202000202222001
102000002200202000201
102222002020202000201
102000002002202000201
102222202000202222001
100000000000000000001
100000000000000000001
111111111111111111111