16
9
1111111111111111
1000000000000001
1010101221010101
1000000000000001
1010101221010101
1000000000000001
1010101221010101
1s00000000000001
1111111111111111
