19
11
1111111111111111111
1000000000000000001
1012101210121012101
1000000000000000001
1210121012101210121
1000000000000000001
1012101212101010101
10222220s0000000001
1012121212101010101
1000222222222000001
1111111111111111111