42
12
111111111111111111111111111111111111111111
122222222222222222222222222222222222222221
122222222222222222222222222222222222222221
122000222200022202220220002220000220002221
122022022022202200200220220220222220220221
122000222022202202020220002220002220002221
122022022022202202220220220220222220202221
122000222200022202220220002220000220220221
122222222222222222222222222222222222222221
1s0000000000000000000000000000000000000001
122222222222222222222222222222222222222221
111111111111111111111111111111111111111111