16
9
1111111111111111
1000000000000001
1020202222020201
1000002020000001
1010202021020101
1020102000000001
1012121121001211
1s00200000000001
111111111111111111