17
9
11111111111111111
10000000000000001
10102010201020101
10000000000000001
10101010101010101
10000000000000001
10102010201020101
1s000000000000001
11111111111111111
