16
9
1111111111111111
1020002000200001
1000200020002001
1020002000200001
1000200020002001
1020002000200001
1000200020002001
1s20002000200001
111111111111111111