21
13
111111111111111111111
100000000000000000001
101020102010201020101
100000000000000000001
102010201020102010201
100000000000000000001
101020102010201020101
100000000000000000001
102010201020102010201
100000000000000000001
101020102010201020101
1s0000000000000000001
111111111111111111111
