20
9
11111111111111111111
10000000000000000001
10000000000000000001
10000000000000000001
10000000000000000001
10202020202020202021
11111111111111111101
1s020000000000000001
11111111111111111111