20
15
11111111111111111111
10000000000000000001
10102011222111121101
11101110201200120101
10010101211110111101
11000101011010100101
10011101011010111001
11000100000000000011
10011102022020111001
12000101011010100011
10010101011010101001
11001100111100210111
10101010121111010101
1s000000000000000001
11111111111111111111