20
15
11111111111111111111
10000000000000000001
10102010222201020101
12002200222200220021
10010101011010101001
12000101011010100021
10011102022020111001
12000000000000000021
10011102022020111001
12000101011010100021
10010101011010101001
12002200222200220021
10102010222201020101
1s000000000000000001
11111111111111111111