20
24
11111111111111111111
1s122212221000000001
10121212121011211121
12221222120012212221
11111111111111112111
12222222222222222221
12111121111121111121
12111121111121111121
12111121111121111121
12111121111121111121
12111121111121111121
11111121111111111111
12222222222222222221
12111121111121111121
12111121111121111121
12111121111121111121
11111111111111111121
12222222222222222221
10000000000000000001
10000000000000000001
10000000000000000001
10000000000000000001
10000000000000000001
11111111111111111111