20
16
11111111111111111111
10212222222222222221
10212000002000200021
10212010200020002021
10222010222222222021
10000010000000000021
11111111110222222201
10002000202000002021
10202020202022202021
10202020202020002021
10202020202022222021
10202020002000000021
10200011111111110021
10222222221000000021
1s000000001222222221
11111111111111111111