21
9
111111111111111111111
100000000000000000001
101020102010201020101
100000000000000000001
101010101010101010101
100000000000000000001
101020102010201020101
1s0000000000000000001
111111111111111111111
